3 4 3 3 4 3 3 4 4 4 3 3 3 4 4 3
4 3 4 4 4 4 3 4 4 3 3 4 3 4 3 3
3 4 3 4 4 3 4 4 4 3 3 4 4 4 4 3
3 4 4 4 4 3 4 4 4 3 3 3 4 4 3 3
4 4 5 4 4 4 5 5 5 5 5 5 5 5 5 5
5 5 5 5 5 5 5 1 1 0 0 1 2 0 2 2
0 0 0 2 1 1 1 0 1 6 6 0 1 1 0 1
2 2 1 1 2 0 0 0 1 6 6 0 1 0 0 0
0 0 1 2 0 1 0 2 0 1 0 0 1 0 2 2
2 1 0 1 2 2 2 0 0 0 0 1 2 0 0 0
2 1 0 2 0 0 1 2 0 0 1 0 1 0 1 0
0 1 0 0 2 0 1 1 0 1 0 1 0 0 0 2

