1 1 1 1 1 1 1 1 1 1 1 1 1 1 1 1 1 1 1 1 1 1 1 1 1 1 1 1 1 1 1 1 2 2 2 2 2 2 2 2 2 2 2 2 2 2 2 2 2 2 2 2 2 2 2 2 2 2 2 2 2 2 2 2 2 
1 0 1 0 0 8 1 8 8 8 0 0 1 8 8 8 8 8 0 8 8 0 1 0 8 8 8 0 1 8 0 8 5 5 5 5 2 5 5 5 5 5 5 5 5 5 5 5 5 5 2 5 5 5 2 5 5 5 5 5 5 5 5 5 2 
1 8 1 1 1 8 1 0 1 1 1 8 1 1 1 1 1 0 1 1 1 0 1 0 1 1 1 8 1 1 1 1 2 5 2 5 2 5 2 2 2 5 2 2 2 2 2 2 2 5 2 2 2 5 2 5 2 2 2 5 2 2 2 5 2 
1 0 8 8 8 0 1 0 1 8 1 8 8 0 8 0 8 8 1 8 1 0 8 0 1 0 8 8 1 8 8 0 2 5 2 5 5 5 2 5 5 5 2 5 5 5 5 5 5 5 2 5 5 5 2 5 2 5 5 5 2 5 5 5 2 
1 1 1 1 1 8 1 8 1 8 1 1 1 1 1 1 1 1 1 0 1 1 1 1 1 0 1 1 1 8 1 0 2 2 2 2 2 2 2 5 2 2 2 2 2 5 2 2 2 2 2 5 2 2 2 5 2 5 2 2 2 5 2 2 2 
1 8 0 8 1 0 8 8 1 8 8 0 8 8 8 8 1 8 0 8 1 8 0 0 1 8 0 8 8 8 1 0 2 5 5 5 5 5 5 5 2 5 2 5 5 5 2 5 5 5 2 5 5 5 2 5 2 5 5 5 2 5 2 5 2 
1 0 1 1 1 1 1 1 1 0 1 1 1 8 1 1 1 0 1 0 1 8 1 8 1 1 1 1 1 1 1 8 2 5 2 2 2 2 2 2 2 5 2 5 2 2 2 5 2 5 2 5 2 5 2 5 2 2 2 5 2 5 2 5 2 
1 8 1 8 0 8 8 8 0 8 0 8 1 8 0 8 1 8 1 8 0 8 1 8 1 8 0 8 0 0 1 8 5 5 2 5 5 5 5 5 5 5 2 5 2 5 5 5 2 5 2 5 2 5 5 5 2 5 2 5 2 5 5 5 2 
1 0 1 8 1 1 1 1 1 1 1 8 1 1 1 8 1 1 1 1 1 8 1 8 1 8 1 1 1 0 1 1 2 2 2 5 2 2 2 5 2 5 2 5 2 2 2 5 2 2 2 5 2 2 2 2 2 5 2 5 2 2 2 5 2 
1 8 8 8 1 0 8 8 1 8 0 0 1 8 1 0 0 8 1 0 0 0 1 0 1 8 8 0 1 8 0 0 5 5 2 5 2 5 5 5 2 5 2 5 5 5 2 5 5 5 5 5 2 5 5 5 5 5 2 5 5 5 2 5 2 
1 1 1 8 1 0 1 0 1 0 1 1 1 0 1 1 1 8 1 8 1 1 1 8 1 1 1 0 1 1 1 1 2 5 2 5 2 5 2 2 2 5 2 2 2 5 2 2 2 5 2 2 2 5 2 5 2 5 2 5 2 5 2 2 2 
1 0 8 0 1 8 1 8 8 0 1 8 1 8 8 0 0 8 1 8 0 8 1 0 1 8 8 8 8 0 0 0 2 5 2 5 2 5 5 5 2 5 2 5 2 5 5 5 2 5 5 5 2 5 2 5 2 5 2 5 2 5 5 5 2 
1 8 1 1 1 8 1 1 1 0 1 8 1 1 1 8 1 1 1 1 1 0 1 8 1 1 1 1 1 1 1 0 2 5 2 5 2 2 2 5 2 5 2 5 2 2 2 5 2 2 2 5 2 2 2 5 2 5 2 2 2 2 2 5 2 
1 0 1 8 8 8 1 8 8 8 1 0 0 8 1 8 1 0 0 0 8 0 1 8 1 8 8 8 8 8 1 8 2 5 2 5 5 5 2 5 2 5 5 5 2 5 2 5 5 5 2 5 5 5 5 5 2 5 2 5 5 5 5 5 2 
1 1 1 8 1 1 1 8 1 1 1 8 1 0 1 8 1 8 1 1 1 1 1 1 1 0 1 8 1 1 1 0 2 5 2 2 2 5 2 5 2 2 2 5 2 5 2 2 2 5 2 2 2 5 2 2 2 2 2 5 2 2 2 2 2 
1 8 0 8 1 0 0 8 1 8 8 8 1 0 1 0 1 8 0 0 8 8 1 8 0 8 1 8 1 8 8 0 2 5 5 5 5 5 2 5 2 5 2 5 2 5 5 5 5 5 2 5 5 5 2 5 5 5 2 5 5 5 5 5 2 
1 8 1 1 1 8 1 1 1 8 1 1 1 8 1 8 1 1 1 1 1 0 1 8 1 1 1 8 1 8 1 8 2 2 2 2 2 2 2 5 2 5 2 5 2 5 2 2 2 2 2 2 2 2 2 5 2 5 2 2 2 5 2 2 2 
1 8 1 0 8 0 1 0 8 8 0 0 1 8 1 8 1 0 0 8 0 8 8 8 8 8 1 0 8 0 1 0 5 5 2 5 5 5 5 5 2 5 2 5 2 5 5 5 5 5 5 5 5 5 5 5 2 5 2 5 2 5 5 5 2 
1 8 1 0 1 1 1 8 1 1 1 1 1 8 1 8 1 1 1 1 1 1 1 1 1 1 1 1 1 1 1 1 2 2 2 5 2 2 2 2 2 5 2 5 2 2 2 2 2 2 2 2 2 2 2 2 2 5 2 5 2 2 2 5 2 
1 8 1 8 0 0 1 0 8 8 1 8 8 0 1 0 1 0 8 8 1 8 0 0 8 0 0 8 1 8 8 8 2 5 5 5 2 5 2 5 5 5 5 5 2 5 5 5 2 5 5 5 2 5 5 5 5 5 2 5 5 5 5 5 2 
1 8 1 1 1 1 1 0 1 1 1 8 1 1 1 0 1 8 1 8 1 1 1 0 1 8 1 0 1 8 1 8 2 5 2 2 2 5 2 5 2 2 2 2 2 5 2 5 2 5 2 5 2 5 2 2 2 2 2 2 2 5 2 5 2 
1 0 0 0 8 8 0 8 1 0 8 8 1 8 1 8 8 0 1 0 8 0 1 8 1 8 1 0 8 8 1 0 5 5 2 5 5 5 2 5 2 5 5 5 5 5 2 5 5 5 2 5 2 5 5 5 2 5 2 5 5 5 2 5 2 
1 1 1 1 1 8 1 1 1 8 1 1 1 8 1 1 1 1 1 1 1 8 1 8 1 1 1 1 1 1 1 1 2 2 2 5 2 2 2 5 2 5 2 2 2 5 2 2 2 5 2 2 2 2 2 5 2 5 2 5 2 2 2 5 2 
1 0 0 8 1 0 0 0 1 8 1 8 1 8 8 8 0 8 1 8 0 8 1 0 0 8 0 8 1 8 8 8 2 5 5 5 2 5 5 5 2 5 5 5 2 5 5 5 2 5 2 5 5 5 5 5 2 5 5 5 2 5 5 5 2 
1 8 1 8 1 1 1 1 1 8 1 0 1 1 1 0 1 0 1 8 1 1 1 1 1 0 1 0 1 8 1 8 2 2 2 5 2 5 2 5 2 5 2 2 2 2 2 5 2 2 2 5 2 2 2 2 2 5 2 2 2 2 2 2 2 
1 8 1 8 8 8 8 8 1 0 1 8 8 0 1 8 1 8 1 8 8 8 0 0 1 0 1 8 1 8 1 0 5 5 2 5 5 5 2 5 2 5 2 5 5 5 5 5 2 5 5 5 2 5 5 5 2 5 5 5 5 5 5 5 2 
1 8 1 1 1 1 1 0 1 8 1 0 1 0 1 8 1 8 1 1 1 1 1 8 1 1 1 0 1 0 1 1 2 5 2 2 2 2 2 2 2 5 2 5 2 2 2 2 2 5 2 2 2 5 2 2 2 5 2 2 2 2 2 5 2 
1 0 8 0 1 8 1 8 8 0 1 0 1 8 8 8 1 0 0 8 1 8 8 0 1 0 8 8 1 0 1 8 2 5 5 5 2 5 5 5 5 5 2 5 5 5 5 5 2 5 2 5 2 5 5 5 5 5 5 5 2 5 5 5 2 
1 1 1 0 1 8 1 1 1 1 1 8 1 1 1 1 1 1 1 1 1 8 1 1 1 0 1 1 1 8 1 8 2 2 2 5 2 5 2 2 2 5 2 2 2 2 2 5 2 5 2 5 2 5 2 2 2 2 2 2 2 5 2 5 2 
1 8 0 8 1 8 1 0 0 0 8 0 0 0 1 8 8 8 0 0 0 8 1 0 8 8 1 0 0 8 1 8 5 5 2 5 2 5 5 5 2 5 2 5 5 5 2 5 5 5 2 5 5 5 5 5 5 5 2 5 5 5 2 5 2 
1 0 1 1 1 8 1 8 1 1 1 1 1 0 1 8 1 1 1 1 1 1 1 1 1 8 1 8 1 1 1 8 2 5 2 5 2 2 2 5 2 2 2 5 2 2 2 2 2 2 2 2 2 2 2 2 2 2 2 5 2 5 2 5 2 
1 0 8 8 1 8 1 0 8 8 0 8 1 0 1 8 1 8 8 0 8 8 8 0 8 0 1 8 8 8 8 8 2 5 2 5 5 5 2 5 5 5 2 5 5 5 5 5 2 5 5 5 5 5 5 5 5 5 5 5 2 5 2 5 2 
1 1 1 0 1 0 1 1 1 1 1 8 1 0 1 0 1 0 1 8 1 1 1 1 1 1 1 1 1 1 1 1 0 7 4 7 4 4 4 4 4 7 4 4 4 7 4 7 4 7 4 4 4 4 4 4 4 4 4 4 4 4 4 7 4 
3 6 6 6 3 6 3 6 6 6 6 6 3 6 3 6 3 6 3 6 6 6 6 6 6 6 6 6 6 6 3 6 6 7 4 7 7 7 4 7 4 7 7 7 4 7 4 7 7 7 4 7 7 7 4 7 7 7 7 7 7 7 7 7 4 
3 6 3 3 3 6 3 6 3 3 3 3 3 6 3 6 3 3 3 6 3 3 3 3 3 3 3 3 3 6 3 3 3 7 4 4 4 7 4 7 4 4 4 7 4 7 4 4 4 4 4 7 4 7 4 7 4 4 4 4 4 4 4 4 4 
3 6 3 6 6 6 6 6 3 6 6 6 6 6 3 6 6 6 3 6 3 6 6 6 6 6 6 6 3 6 3 6 6 7 7 7 4 7 7 7 4 7 4 7 7 7 4 7 7 7 4 7 4 7 7 7 4 7 4 7 7 7 7 7 4 
3 6 3 3 3 3 3 6 3 6 3 3 3 3 3 3 3 6 3 3 3 6 3 3 3 3 3 6 3 6 3 6 3 4 4 4 4 4 4 7 4 7 4 4 4 4 4 7 4 7 4 7 4 4 4 4 4 7 4 7 4 7 4 4 4 
3 6 3 6 6 6 3 6 3 6 6 6 6 6 6 6 3 6 6 6 3 6 3 6 6 6 3 6 6 6 3 6 6 7 7 7 7 7 4 7 7 7 7 7 4 7 7 7 4 7 7 7 4 7 7 7 7 7 7 7 4 7 7 7 4 
3 6 3 6 3 6 3 3 3 3 3 3 3 3 3 6 3 3 3 6 3 6 3 6 3 6 3 3 3 6 3 3 3 4 4 4 4 7 4 4 4 7 4 4 4 7 4 4 4 4 4 4 4 7 4 4 4 4 4 4 4 4 4 7 4 
3 6 3 6 3 6 6 6 3 6 6 6 6 6 6 6 6 6 3 6 6 6 3 6 3 6 6 6 6 6 6 6 6 7 7 7 4 7 4 7 7 7 4 7 7 7 4 7 7 7 4 7 7 7 4 7 7 7 7 7 7 7 4 7 4 
3 6 3 6 3 3 3 6 3 3 3 3 3 6 3 3 3 6 3 6 3 3 3 3 3 6 3 3 3 3 3 3 3 7 4 4 4 7 4 7 4 4 4 7 4 4 4 7 4 4 4 7 4 4 4 4 4 4 4 7 4 7 4 7 4 
3 6 3 6 6 6 3 6 6 6 3 6 3 6 6 6 3 6 6 6 3 6 6 6 3 6 3 6 6 6 3 6 6 7 4 7 7 7 4 7 7 7 7 7 4 7 7 7 7 7 4 7 7 7 7 7 7 7 4 7 4 7 4 7 4 
3 6 3 3 3 6 3 3 3 6 3 6 3 6 3 3 3 3 3 3 3 6 3 6 3 3 3 6 3 6 3 3 3 7 4 7 4 4 4 4 4 4 4 4 4 4 4 4 4 7 4 4 4 4 4 7 4 7 4 7 4 7 4 7 4 
3 6 6 6 6 6 3 6 6 6 3 6 6 6 3 6 6 6 6 6 3 6 3 6 6 6 3 6 3 6 6 6 3 7 4 7 7 7 4 7 7 7 7 7 7 7 4 7 4 7 7 7 7 7 7 7 4 7 7 7 4 7 4 7 4 
3 6 3 3 3 3 3 6 3 6 3 6 3 3 3 6 3 3 3 6 3 6 3 3 3 6 3 6 3 3 3 6 3 7 4 4 4 7 4 4 4 7 4 4 4 7 4 7 4 7 4 4 4 4 4 4 4 4 4 4 4 4 4 7 4 
3 6 6 6 3 6 6 6 3 6 3 6 6 6 3 6 6 6 3 6 6 6 3 6 3 6 6 6 6 6 3 6 3 7 4 7 7 7 4 7 7 7 4 7 4 7 7 7 4 7 4 7 4 7 7 7 4 7 7 7 4 7 7 7 4 
3 3 3 3 3 6 3 3 3 3 3 6 3 3 3 3 3 6 3 3 3 3 3 6 3 3 3 3 3 3 3 6 3 4 4 7 4 4 4 7 4 4 4 7 4 4 4 7 4 7 4 7 4 7 4 7 4 7 4 7 4 7 4 7 4 
3 6 6 6 6 6 3 6 6 6 3 6 3 6 6 6 3 6 6 6 3 6 3 6 3 6 6 6 3 6 6 6 3 7 7 7 4 7 7 7 7 7 4 7 7 7 7 7 4 7 7 7 4 7 4 7 7 7 4 7 7 7 4 7 4 
3 6 3 6 3 3 3 6 3 6 3 3 3 6 3 6 3 3 3 6 3 6 3 6 3 6 3 6 3 6 3 3 3 7 4 4 4 4 4 7 4 7 4 4 4 4 4 7 4 4 4 4 4 7 4 4 4 4 4 4 4 4 4 7 4 
3 6 3 6 3 6 6 6 3 6 6 6 6 6 3 6 6 6 6 6 3 6 3 6 6 6 3 6 3 6 6 6 3 7 7 7 7 7 4 7 4 7 7 7 7 7 4 7 7 7 4 7 7 7 4 7 7 7 4 7 7 7 4 7 4 
3 6 3 3 3 6 3 3 3 3 3 3 3 3 3 3 3 3 3 3 3 6 3 6 3 3 3 6 3 3 3 6 3 4 4 4 4 7 4 4 4 4 4 4 4 7 4 4 4 7 4 7 4 4 4 7 4 7 4 7 4 7 4 7 4 
3 6 3 6 6 6 3 6 6 6 3 6 6 6 6 6 3 6 6 6 6 6 3 6 6 6 3 6 3 6 6 6 3 7 7 7 4 7 7 7 4 7 7 7 7 7 4 7 7 7 4 7 7 7 7 7 4 7 4 7 4 7 4 7 4 
3 6 3 6 3 3 3 6 3 6 3 3 3 6 3 6 3 6 3 6 3 3 3 3 3 6 3 3 3 6 3 6 3 7 4 4 4 4 4 7 4 7 4 4 4 4 4 7 4 4 4 4 4 4 4 4 4 7 4 7 4 4 4 7 4 
3 6 3 6 6 6 3 6 3 6 6 6 6 6 3 6 6 6 3 6 3 6 6 6 6 6 3 6 6 6 3 6 6 7 7 7 7 7 4 7 7 7 4 7 7 7 4 7 7 7 4 7 7 7 7 7 7 7 4 7 7 7 7 7 4 
3 6 3 3 3 6 3 6 3 3 3 3 3 3 3 3 3 3 3 6 3 6 3 6 3 3 3 6 3 3 3 3 3 7 4 4 4 4 4 4 4 4 4 7 4 4 4 7 4 7 4 7 4 4 4 4 4 4 4 7 4 4 4 4 4 
3 6 6 6 3 6 3 6 6 6 6 6 3 6 6 6 6 6 3 6 3 6 3 6 6 6 3 6 3 6 6 6 3 7 4 7 7 7 4 7 7 7 4 7 7 7 4 7 4 7 4 7 4 7 7 7 4 7 7 7 4 7 7 7 4 
3 3 3 6 3 6 3 3 3 6 3 6 3 6 3 3 3 6 3 6 3 3 3 6 3 6 3 6 3 6 3 6 3 4 4 7 4 7 4 7 4 7 4 7 4 7 4 7 4 4 4 7 4 7 4 7 4 7 4 4 4 7 4 7 4 
3 6 6 6 3 6 6 6 3 6 3 6 3 6 3 6 6 6 3 6 6 6 3 6 3 6 3 6 6 6 3 6 6 7 7 7 4 7 4 7 4 7 4 7 4 7 4 7 4 7 7 7 4 7 4 7 4 7 4 7 7 7 4 7 4 
3 6 3 3 3 3 3 6 3 6 3 6 3 3 3 6 3 3 3 3 3 6 3 3 3 6 3 3 3 3 3 3 3 4 4 4 4 7 4 7 4 7 4 4 4 7 4 7 4 7 4 4 4 7 4 4 4 7 4 7 4 4 4 7 4 
3 6 3 6 6 6 6 6 3 6 3 6 6 6 3 6 6 6 3 6 6 6 3 6 6 6 6 6 3 6 3 6 6 7 7 7 4 7 7 7 4 7 7 7 4 7 4 7 7 7 4 7 7 7 4 7 7 7 4 7 4 7 7 7 4 
3 6 3 6 3 3 3 3 3 3 3 6 3 6 3 6 3 6 3 6 3 3 3 6 3 3 3 6 3 6 3 6 3 4 4 7 4 7 4 4 4 4 4 7 4 7 4 7 4 4 4 7 4 4 4 7 4 4 4 4 4 7 4 7 4 
3 6 3 6 6 6 3 6 6 6 3 6 3 6 3 6 3 6 6 6 3 6 6 6 3 6 6 6 3 6 6 6 3 7 7 7 4 7 4 7 7 7 7 7 7 7 4 7 4 7 7 7 7 7 4 7 7 7 7 7 7 7 4 7 4 
3 6 3 3 3 6 3 6 3 6 3 3 3 6 3 6 3 3 3 3 3 6 3 3 3 6 3 3 3 6 3 3 3 7 4 4 4 7 4 4 4 4 4 4 4 4 4 7 4 7 4 4 4 4 4 4 4 4 4 4 4 4 4 7 4 
3 6 6 6 6 6 6 6 3 6 6 6 6 6 3 6 6 6 6 6 6 6 3 6 6 6 6 6 6 6 3 6 6 7 7 7 4 7 7 7 7 7 7 7 7 7 7 7 4 7 7 7 7 7 7 7 7 7 7 7 7 7 7 7 4 
3 3 3 3 3 3 3 3 3 3 3 3 3 3 3 3 3 3 3 3 3 3 3 3 3 3 3 3 3 3 3 3 3 4 4 4 4 4 4 4 4 4 4 4 4 4 4 4 4 4 4 4 4 4 4 4 4 4 4 4 4 4 4 4 4 
